1 1 1 9 1 1 1 0 1 1 1 1 1 8 1 1 1 1 0 0 0 0
1 1 1 1 1 1 1 0 1 1 1 1 1 1 1 1 1 1 0 0 0 0
1 1 1 1 1 1 1 0 2 1 1 1 1 1 1 1 1 1 1 1 0 0
1 1 1 1 1 1 1 0 1 1 1 1 1 1 1 1 1 1 1 1 0 0
10 1 1 1 1 1 1 1 1 1 1 1 1 1 1 1 1 1 1 1 0 0
1 1 1 1 1 1 1 1 1 1 1 1 1 1 1 1 1 1 1 1 0 0
1 1 1 1 1 1 1 0 1 1 1 1 1 1 1 1 1 1 1 1 1 1
1 1 1 11 1 1 1 0 1 1 1 1 1 1 1 0 1 1 1 1 1 1
0 0 0 0 0 0 0 0 4 1 1 1 1 1 1 0 1 1 1 1 1 1
0 0 0 0 0 0 0 0 1 1 1 1 1 1 1 0 1 1 1 1 1 1
0 0 0 0 0 0 0 0 1 1 1 1 1 1 1 0 1 1 1 1 1 6
0 0 0 0 0 0 0 0 0 0 0 0 1 1 0 0 1 1 1 1 1 1
0 0 0 0 0 0 0 0 1 1 1 1 1 1 1 0 1 1 1 1 1 1
0 0 0 0 0 0 0 0 1 1 1 1 1 1 1 0 1 1 1 1 1 1
0 0 0 0 0 0 0 0 1 1 1 1 1 1 1 0 1 1 1 1 1 1
0 0 0 0 0 0 0 0 1 3 1 1 5 1 1 0 1 1 1 7 1 1
